00 00 00 00 00 00 00 00 00 00 00 00 00 00 00 00 00 00 00 00 00 00 00 00 00 00 00 00
00 00 00 00 00 00 00 00 00 00 00 00 00 00 00 00 00 00 00 00 00 00 00 00 00 00 00 00
00 00 00 00 00 00 00 00 00 00 00 00 00 00 00 00 00 00 00 00 00 00 00 00 00 00 00 00
41 13 13 13 13 13 13 13 13 13 13 13 13 33 23 13 13 13 13 13 13 13 13 13 13 13 13 42
12 71 71 71 71 71 71 71 71 71 71 71 71 54 52 71 71 71 71 71 71 71 71 71 71 71 71 14
12 71 61 51 51 62 71 61 51 51 51 62 71 54 52 71 61 51 51 51 62 71 61 51 51 62 71 14
12 72 54 00 00 52 71 54 00 00 00 52 71 54 52 71 54 00 00 00 52 71 54 00 00 52 72 14
12 71 64 53 53 63 71 64 53 53 53 63 71 64 63 71 64 53 53 53 63 71 64 53 53 63 71 14
12 71 71 71 71 71 71 71 71 71 71 71 71 71 71 71 71 71 71 71 71 71 71 71 71 71 71 14
12 71 61 51 51 62 71 61 62 71 61 51 51 51 51 51 51 61 71 61 62 71 61 51 51 62 71 14
12 71 64 53 53 63 71 54 52 71 64 53 53 62 61 53 53 63 71 54 52 71 64 53 53 63 71 14
12 71 71 71 71 71 71 54 52 71 71 71 71 54 52 71 71 71 71 54 52 71 71 71 71 71 71 14
44 11 11 11 11 62 71 54 64 51 51 62 00 54 52 00 61 51 51 63 52 71 61 11 11 11 11 43
00 00 00 00 00 12 71 54 61 53 53 63 00 64 63 00 64 53 53 62 52 71 14 00 00 00 00 00
00 00 00 00 00 12 71 54 52 00 00 00 00 00 00 00 00 00 00 54 52 71 14 00 00 00 00 00
00 00 00 00 00 12 71 54 52 00 81 81 81 81 81 81 81 81 00 54 52 71 14 00 00 00 00 00
13 13 13 13 13 63 71 64 63 00 81 00 00 00 00 00 00 81 00 64 63 71 64 13 13 13 13 13
00 00 00 00 00 00 71 00 00 00 81 00 00 00 00 00 00 81 00 00 00 71 00 00 00 00 00 00
11 11 11 11 11 62 71 61 62 00 81 00 00 00 00 00 00 81 00 61 62 71 61 11 11 11 11 11
00 00 00 00 00 12 71 54 52 00 81 81 81 81 81 81 81 81 00 54 52 71 14 00 00 00 00 00
00 00 00 00 00 12 71 54 52 00 00 00 00 00 00 00 00 00 00 54 52 71 14 00 00 00 00 00
00 00 00 00 00 12 71 54 52 00 61 51 51 51 51 51 51 62 00 54 52 71 14 00 00 00 00 00
41 13 13 13 13 63 71 64 63 00 64 53 53 62 61 53 53 63 00 64 63 71 64 13 13 13 13 42
12 71 71 71 71 71 71 71 71 71 71 71 71 54 52 71 71 71 71 71 71 71 71 71 71 71 71 14
12 71 61 51 51 62 71 61 51 51 51 62 71 54 52 71 61 51 51 51 62 71 61 51 51 62 71 14
12 71 64 53 62 52 71 64 53 53 53 63 71 64 63 71 64 53 53 53 63 71 54 61 53 63 71 14
12 72 71 71 54 52 71 71 71 71 71 71 71 00 00 71 71 71 71 71 71 71 54 52 71 71 72 14
22 51 62 71 54 52 71 61 62 71 61 51 51 51 51 51 51 62 71 61 62 71 54 52 71 61 51 21
32 53 63 71 64 63 71 54 52 71 64 53 53 62 61 53 53 63 71 54 52 71 64 63 71 64 53 24
12 71 71 71 71 71 71 54 52 71 71 71 71 54 52 71 71 71 71 54 52 71 71 71 71 71 71 14
12 71 61 51 51 51 51 63 64 51 51 62 71 54 52 71 61 51 51 63 64 51 51 51 51 62 71 14
12 71 64 53 53 53 53 53 53 53 53 63 71 64 63 71 64 53 53 53 53 53 53 53 53 63 71 14
12 71 71 71 71 71 71 71 71 71 71 71 71 71 71 71 71 71 71 71 71 71 71 71 71 71 71 14
44 11 11 11 11 11 11 11 11 11 11 11 11 11 11 11 11 11 11 11 11 11 11 11 11 11 11 43
00 00 00 00 00 00 00 00 00 00 00 00 00 00 00 00 00 00 00 00 00 00 00 00 00 00 00 00
00 00 00 00 00 00 00 00 00 00 00 00 00 00 00 00 00 00 00 00 00 00 00 00 00 00 00 00